11111111111111111111
10P00C0000C000010101
10111111111111111111
1CCCC0000000000000E1
11111111111111111111
