111111111
10P00C001
101111111
1CCCCE001
111111111
