111111111111111111111111111111
10000CCC0000000000000000000001
1000C00C0000000000000000000001
110000E00000000000000000000001
10000000000000P000000000000001
100000000000000000000000000001
100000000000000000000000000001
100000000000000000000000000001
111111111111111111111111111111
